001 000 001 001 001 001 001 001 001 001 001 001 001 001 001 001 001 001 001 001 001 001 001 001 001 001 001 001 001 001 001 001 001 001 001 001 001 001 001 001 001 001 001 001 001
001 000 000 000 000 000 000 000 001 001 001 000 000 000 000 000 000 000 000 000 000 000 000 000 000 000 000 000 000 001 000 001 000 000 000 000 000 000 000 000 000 000 000 000 001
001 000 000 000 000 000 000 000 000 001 001 000 000 000 000 001 000 000 000 000 000 000 000 000 000 000 000 001 000 000 001 000 000 000 000 022 022 022 022 022 022 022 000 000 001
001 000 000 000 000 000 000 000 000 001 001 000 000 000 000 000 001 000 000 000 000 000 000 000 001 000 000 000 000 001 000 001 000 000 027 028 028 028 028 028 028 028 023 000 001
001 000 000 000 000 000 000 000 000 001 001 000 000 000 000 000 000 000 000 001 000 000 001 000 000 000 000 000 000 001 001 000 000 000 027 028 028 028 028 028 028 028 023 000 001
001 000 000 000 000 000 000 000 000 001 001 000 000 000 000 000 000 001 000 000 000 000 000 000 000 001 000 000 000 001 001 000 000 000 027 028 028 028 028 028 028 028 023 000 001
001 000 000 000 000 000 000 000 000 001 001 000 000 000 000 000 000 000 000 000 000 000 000 000 000 000 000 000 000 001 001 001 000 000 027 028 028 028 028 028 028 028 023 000 001
001 000 000 000 000 000 000 000 001 001 001 000 000 001 000 000 000 000 000 000 000 000 001 000 000 000 000 000 000 001 001 001 001 000 027 028 028 028 028 028 028 028 023 000 001
001 000 000 000 000 000 000 000 001 000 000 000 000 000 000 001 000 000 000 000 000 000 000 000 001 000 001 000 000 000 000 001 001 000 027 028 028 028 028 028 028 028 023 000 001
001 000 000 000 000 000 000 001 001 000 000 000 000 000 000 000 000 000 000 001 000 000 000 000 000 000 000 000 000 000 001 001 001 000 000 025 025 025 025 025 025 025 000 000 001
001 000 000 000 000 000 000 001 001 000 000 000 000 000 000 000 000 000 000 000 000 000 000 000 000 000 000 000 000 000 000 001 001 001 000 000 000 000 000 000 000 000 000 001 001
001 000 000 000 000 000 000 000 001 000 001 000 000 000 000 000 000 000 000 000 000 000 000 001 000 000 000 000 000 000 000 000 001 001 001 001 000 000 000 000 000 000 001 000 001
001 000 000 000 000 000 000 000 001 000 001 000 000 000 000 000 000 000 000 000 000 000 000 000 000 000 000 000 000 000 001 000 000 001 001 001 001 000 000 000 000 001 001 000 001
001 000 000 000 000 000 000 000 001 000 000 001 000 000 000 000 001 000 000 000 000 000 000 000 000 001 000 000 001 000 000 000 000 000 001 001 001 001 000 000 001 001 001 000 001
001 000 000 000 000 000 000 000 001 001 001 001 000 000 000 000 000 000 000 000 000 000 000 000 000 000 000 000 000 000 000 000 000 000 000 000 001 001 000 000 000 000 000 000 001
001 000 000 001 000 000 000 000 000 001 001 001 000 000 000 000 000 000 000 000 000 000 000 000 000 000 000 000 000 000 000 001 000 000 000 000 000 000 000 000 000 000 000 000 001
001 000 000 000 000 000 000 000 000 001 001 001 001 000 001 000 000 000 000 000 000 000 001 000 000 000 000 000 000 000 000 000 000 000 000 000 000 000 000 000 000 000 000 000 001
001 000 000 000 000 000 000 000 000 000 001 001 000 000 000 000 000 000 000 000 000 000 000 000 000 000 000 000 000 000 000 000 000 000 000 000 000 000 000 000 000 000 000 000 001
001 000 000 000 000 001 000 000 000 000 001 001 000 000 000 000 000 001 000 000 000 000 000 000 000 000 000 000 000 000 000 000 001 000 000 000 000 000 000 000 000 000 000 000 001
001 000 000 000 000 000 000 000 000 000 000 001 000 000 000 000 000 000 000 000 000 000 000 001 000 000 000 000 001 000 000 000 001 000 000 000 000 000 000 000 000 000 000 000 001
001 000 001 000 000 000 000 000 000 000 000 000 000 000 000 000 000 000 000 000 000 000 000 000 000 000 000 000 000 000 000 000 000 000 000 001 000 000 000 000 000 000 000 000 001
001 000 000 000 000 000 000 000 000 000 000 000 000 000 000 000 000 000 000 000 001 000 000 000 000 000 000 000 000 000 000 000 000 000 000 000 000 000 000 001 000 000 000 000 001
001 000 000 000 000 000 000 001 000 000 000 000 000 000 000 000 000 000 000 000 000 000 000 000 001 000 000 001 000 000 000 000 000 001 000 000 000 000 000 000 000 001 000 000 001
001 000 000 000 000 000 000 000 000 000 001 000 000 000 000 000 000 001 000 000 000 001 000 000 000 000 000 000 000 000 000 000 000 000 000 000 000 000 000 000 000 000 000 000 001
001 000 000 001 000 000 000 000 000 000 000 000 000 000 000 000 000 000 000 000 000 000 000 000 000 000 000 000 000 000 000 000 000 000 000 000 000 000 000 000 000 000 000 000 001
001 000 000 000 000 000 000 000 000 000 000 000 000 000 000 000 000 000 000 000 000 001 001 001 000 000 000 000 000 000 000 000 000 000 000 000 000 000 000 000 000 000 000 000 001
001 000 000 000 001 000 001 000 000 000 000 000 000 000 001 000 001 000 000 000 014 007 007 007 007 007 007 008 000 014 007 007 007 007 007 007 007 008 000 000 000 000 000 001 001
001 000 000 000 000 000 000 000 000 000 000 000 000 000 000 000 000 000 000 000 013 003 004 003 004 003 004 009 000 013 003 004 003 004 003 004 003 009 001 001 001 001 000 000 001
001 000 000 000 000 000 000 000 000 000 000 000 000 000 000 000 000 000 000 000 013 005 006 005 006 005 006 009 000 013 005 006 005 006 005 006 005 009 000 000 000 000 000 000 001
001 000 000 000 000 000 000 000 000 000 001 000 000 000 000 000 001 000 000 000 013 003 004 003 004 016 011 010 000 012 011 017 003 004 003 004 003 009 000 000 000 000 000 000 001
001 000 000 000 000 000 001 000 000 000 000 000 000 000 000 000 000 000 000 000 013 005 006 005 006 009 000 000 000 000 000 013 005 006 005 006 005 009 000 000 000 000 000 000 001
001 000 000 000 000 000 000 000 000 000 000 000 000 000 000 000 000 000 000 000 013 003 004 003 004 009 000 000 000 000 000 013 003 004 003 004 003 009 000 000 000 000 000 000 001
001 000 000 000 000 000 000 001 000 000 000 000 000 014 007 007 007 007 007 007 018 005 006 005 006 009 000 000 000 000 000 013 005 006 005 006 005 009 000 000 000 000 000 000 001
001 000 000 000 000 000 000 000 000 000 000 000 000 013 003 004 003 004 003 004 003 004 003 004 003 009 001 000 000 000 000 013 003 004 003 004 003 009 000 000 000 000 001 000 001
001 000 000 000 001 000 000 000 000 000 000 014 007 018 005 006 005 006 005 006 005 006 005 006 004 015 007 007 007 007 007 018 005 006 005 006 005 009 000 000 000 000 000 000 001
001 000 000 000 000 000 000 000 000 000 000 013 003 004 003 004 003 004 003 004 003 004 003 004 003 004 003 004 003 004 003 004 003 004 003 004 003 009 000 000 001 000 000 000 001
001 000 000 000 000 000 000 000 014 007 007 018 005 006 005 006 005 006 005 006 005 006 005 006 005 006 005 006 005 006 005 006 005 006 005 006 005 009 000 000 000 000 000 000 001
001 000 001 000 000 000 000 000 013 004 003 004 003 004 003 004 003 004 003 004 003 004 003 004 003 004 003 004 003 004 003 004 003 004 003 004 003 009 000 000 000 000 000 000 001
001 000 000 000 000 001 000 000 013 006 005 006 005 006 005 006 005 006 005 006 005 006 005 006 005 006 005 006 005 006 005 006 005 006 005 006 005 009 000 000 000 000 000 000 001
001 000 000 000 000 000 000 000 012 017 003 004 003 004 003 004 003 004 003 004 003 004 003 004 003 004 003 004 003 004 003 004 003 004 003 004 003 009 000 000 000 000 000 000 001
001 001 001 001 001 001 001 001 001 013 005 006 005 006 005 006 005 006 005 006 005 006 005 006 005 006 005 006 005 006 005 006 005 006 005 006 005 009 001 001 001 001 001 001 001
