028 023 001 001 001 001 001 001 001 001 001 001 022 022 022 039 028 040 022 001 001 001 001 001 001 001 013 003 004 009 001 001 001 001 001 001 001 001 001 001 001 001 001 001 001 001 001 001 001 001
025 028 028 040 000 000 000 001 002 002 002 027 028 028 029 029 028 028 028 023 000 000 000 000 000 000 013 005 006 009 000 001 000 000 000 000 001 000 000 000 000 001 000 000 000 000 000 000 000 001
001 028 028 028 023 000 000 001 002 002 002 027 028 029 029 029 028 028 028 023 000 000 000 000 000 000 012 017 016 010 000 000 000 000 000 000 000 000 000 000 000 001 000 000 000 000 002 000 000 001
001 025 038 028 023 000 000 001 000 002 002 027 028 029 029 028 028 028 028 023 000 000 000 000 000 000 001 013 009 000 000 000 000 000 000 000 000 000 000 000 000 001 000 000 000 002 002 002 000 001
001 000 027 028 023 000 000 001 000 000 000 027 028 028 028 028 028 028 028 023 000 000 000 000 000 001 001 013 009 000 000 000 000 000 000 000 000 000 000 000 001 001 000 000 000 000 000 000 000 001
001 000 027 028 040 022 022 022 022 022 022 039 028 029 029 029 028 028 028 023 000 000 000 000 000 001 021 019 020 000 000 000 000 000 000 000 000 000 000 000 000 001 000 000 000 000 000 000 000 001
001 000 027 028 028 028 028 028 028 028 028 028 028 028 028 028 028 028 028 023 000 000 000 000 000 001 021 013 009 000 000 000 000 000 000 000 000 000 000 000 000 001 000 000 000 000 000 000 001 001
001 000 000 025 025 025 025 025 025 025 025 025 025 025 025 025 025 021 025 000 000 000 001 001 001 001 021 013 009 000 000 000 000 000 000 000 000 000 000 000 000 001 000 000 000 000 000 000 001 001
001 000 000 000 000 000 000 000 000 000 000 000 000 000 000 000 000 021 000 000 000 000 000 021 021 021 021 013 009 000 000 000 000 000 000 000 000 000 000 000 000 000 000 001 000 000 001 000 000 001
001 000 001 000 000 001 000 001 000 000 000 000 000 000 000 000 000 021 000 000 000 000 000 021 000 000 000 013 015 007 007 007 007 007 007 008 000 000 000 000 000 000 000 000 000 000 001 000 001 001
001 000 000 000 000 000 000 000 000 000 000 000 000 000 000 000 000 021 000 000 000 000 000 021 000 000 000 012 011 011 011 011 011 011 017 009 000 000 000 000 000 000 000 000 000 000 000 000 000 001
001 000 000 001 001 001 000 000 000 000 000 000 000 000 001 001 001 021 021 021 021 021 021 021 000 000 000 000 000 001 001 001 001 001 013 009 000 000 000 000 000 000 000 000 000 000 000 000 001 001
001 001 001 001 001 001 000 000 001 000 000 000 000 000 001 001 001 001 001 001 001 001 000 021 000 000 000 000 000 000 000 000 000 001 013 009 001 000 000 000 000 000 000 000 000 000 000 000 000 001
001 001 001 001 001 001 000 001 001 001 001 001 001 001 001 000 001 001 000 000 001 000 001 021 000 000 001 000 000 001 000 000 000 000 013 015 007 007 007 007 007 007 007 007 007 007 007 007 007 007
001 000 000 000 000 001 001 001 001 000 001 001 001 001 001 000 000 001 000 000 001 000 000 021 000 000 000 000 000 000 000 000 000 000 012 011 011 011 011 011 011 011 011 017 003 004 003 004 003 004
001 000 000 000 000 000 000 001 000 001 001 000 001 000 000 000 000 001 000 000 000 000 000 021 000 000 000 000 000 000 000 000 000 000 000 000 000 000 000 000 000 000 001 012 017 006 005 006 005 006
001 000 000 001 000 002 002 000 000 000 000 000 000 000 000 000 000 000 000 000 000 000 000 021 000 001 000 000 000 000 001 000 000 002 000 000 000 000 000 000 000 000 000 001 013 004 003 004 003 004
001 000 000 000 001 002 002 000 000 000 000 000 000 000 000 000 000 000 000 000 000 000 000 021 000 000 000 001 000 001 000 002 002 002 002 002 000 000 000 000 000 000 000 000 013 006 005 006 005 006
001 000 000 000 000 002 002 002 002 002 002 002 002 002 000 000 001 000 001 000 000 000 000 021 000 000 000 000 000 001 001 002 002 002 002 002 000 000 000 000 002 000 000 000 013 004 003 004 003 004
001 000 000 001 000 002 002 002 002 002 002 002 002 002 000 000 000 000 000 000 000 000 000 021 000 000 000 000 001 000 001 002 002 002 002 002 000 000 000 000 000 000 000 000 013 006 005 006 005 006
001 000 000 000 000 002 002 002 002 002 002 002 002 002 000 000 000 000 000 000 021 021 021 021 021 021 021 000 000 000 000 002 002 002 002 002 000 002 000 000 000 000 000 000 013 004 003 004 003 004
001 000 000 000 000 002 002 002 002 002 002 002 002 002 000 000 000 000 000 000 021 021 021 021 021 021 021 000 000 000 000 002 002 000 002 002 000 000 000 000 000 000 000 000 013 006 003 006 005 006
001 000 000 000 000 002 002 002 002 002 002 002 000 000 000 000 000 000 000 000 021 021 021 021 021 021 021 000 000 000 000 002 002 000 002 002 000 000 000 000 002 002 000 000 012 017 005 004 003 004
001 000 000 000 000 021 021 021 021 021 021 021 021 021 021 021 021 021 021 021 021 021 021 041 021 021 021 021 021 021 021 021 021 021 021 021 021 021 021 021 021 021 021 021 021 012 017 006 005 006
001 000 000 001 000 000 000 021 000 000 000 000 000 000 000 001 000 000 000 000 021 021 021 041 021 021 021 000 000 000 000 000 000 021 000 000 000 000 000 000 000 000 000 000 000 001 013 004 003 004
001 000 000 000 000 000 000 021 000 000 000 000 000 000 000 000 000 000 000 000 021 021 021 021 021 021 021 000 000 000 000 000 000 021 000 000 000 002 000 000 000 000 000 000 000 001 012 011 011 011
001 001 044 042 042 042 042 021 042 042 042 042 045 000 000 000 000 000 000 000 021 021 021 021 021 021 021 000 000 000 000 000 000 021 000 002 002 002 002 002 000 000 000 000 000 001 001 001 001 001
001 001 043 000 000 000 000 000 000 000 000 000 043 000 000 000 000 000 000 000 000 000 000 021 002 000 022 022 022 022 022 022 000 021 000 002 002 002 002 002 000 000 000 000 000 000 001 001 001 001
001 001 043 000 000 000 000 000 001 000 000 000 043 001 000 000 000 000 000 000 000 000 000 021 002 027 028 028 028 028 028 028 023 021 000 002 002 002 002 002 000 000 000 000 000 000 001 001 001 001
001 001 043 000 001 000 000 000 000 000 000 000 043 001 001 000 000 000 000 000 000 000 000 021 002 027 028 028 028 028 028 028 023 021 000 002 002 002 002 002 000 000 000 000 000 000 000 000 001 001
001 001 043 000 000 000 000 000 000 000 000 000 043 001 001 000 000 000 002 002 002 002 002 021 002 027 028 028 028 028 028 028 023 021 000 002 002 002 002 002 000 000 000 000 000 000 000 001 001 001
001 001 043 000 000 000 000 000 000 000 000 000 043 001 001 000 000 000 002 002 002 002 002 021 002 027 028 028 028 028 028 028 023 021 002 002 002 000 002 002 000 000 000 000 000 000 000 001 001 001
001 000 043 000 000 000 000 000 000 000 000 000 043 001 001 001 000 000 002 000 002 002 002 021 002 027 028 028 028 028 028 028 023 021 021 021 021 021 021 021 000 000 000 000 000 001 001 000 001 001
001 000 043 001 000 000 000 000 000 000 000 000 043 001 001 001 000 000 002 002 002 002 002 021 002 027 028 028 028 028 028 028 023 021 001 001 001 001 001 001 000 000 000 000 000 000 001 000 001 001
001 001 046 042 042 042 042 042 042 042 042 042 047 001 001 000 000 000 002 002 002 002 002 021 002 027 028 028 028 028 028 028 023 021 000 000 000 000 000 000 000 000 000 000 000 000 000 001 001 001
001 001 001 000 001 001 001 001 001 001 001 001 001 001 001 000 000 000 002 002 000 002 002 021 002 027 028 028 028 028 028 028 023 021 000 000 000 002 000 000 000 000 000 000 000 001 000 000 001 001
001 001 001 001 001 001 001 000 000 001 000 001 001 001 001 001 000 000 002 002 000 002 002 021 002 027 028 028 028 028 028 028 023 021 000 002 002 002 002 002 000 000 000 000 000 001 000 001 001 001
001 000 000 001 000 001 000 000 000 000 000 001 001 001 001 001 001 000 021 021 021 021 021 021 002 027 028 028 028 028 028 028 023 021 000 002 002 002 002 002 000 000 000 000 000 000 000 000 001 001
001 000 000 000 000 000 000 000 000 000 001 001 001 001 001 001 001 000 000 000 000 000 000 021 002 027 028 028 028 028 028 028 023 021 000 002 002 002 002 002 000 000 000 000 000 001 001 001 001 001
001 001 000 001 000 000 000 000 000 000 001 001 001 001 000 001 000 000 000 000 000 000 000 021 002 027 028 028 028 028 028 028 023 021 000 002 002 002 002 002 000 000 000 000 000 000 000 000 001 001
001 000 000 000 000 000 000 000 000 000 001 001 001 001 000 001 000 001 000 000 000 000 000 021 002 027 028 028 028 028 028 028 023 021 000 002 002 000 002 002 000 000 000 000 000 001 001 000 001 001
001 000 000 000 000 000 000 000 000 000 001 001 001 001 001 001 000 001 000 000 000 000 000 021 002 027 028 028 028 028 028 028 023 021 000 000 000 000 000 000 000 000 000 000 000 000 000 001 001 001
001 001 000 000 000 000 000 000 000 000 000 001 001 001 001 001 000 001 000 000 000 000 000 021 002 000 025 025 025 025 025 025 000 021 021 021 021 021 021 021 000 000 000 000 000 000 001 001 001 001
001 001 000 000 000 000 000 001 000 000 001 001 001 001 000 001 001 001 001 000 000 000 000 021 000 000 000 000 000 000 000 000 000 000 000 000 000 000 000 000 000 000 000 000 000 001 001 000 001 001
001 001 000 000 000 000 000 000 000 001 001 001 001 000 000 001 000 001 001 000 000 000 000 021 000 000 000 000 000 000 000 000 000 000 000 000 000 000 000 000 000 000 000 000 000 000 001 000 000 001
001 001 000 000 000 000 000 000 000 000 000 000 000 000 001 001 000 001 001 001 000 000 000 021 000 000 000 000 000 000 000 000 000 000 000 000 000 000 000 000 000 000 000 000 000 001 001 001 000 001
001 001 000 000 000 000 000 000 000 000 000 000 000 000 000 000 000 001 001 001 000 000 000 021 000 000 000 000 000 000 000 000 000 000 000 000 000 000 000 000 000 000 000 000 000 000 001 001 001 001
001 000 000 000 000 000 000 000 000 000 000 000 000 000 001 001 000 000 000 000 000 000 000 021 000 000 000 000 000 000 000 000 000 000 000 000 000 000 000 000 000 000 000 000 000 000 000 001 001 001
001 000 000 000 000 000 000 000 000 000 000 000 000 000 000 000 021 021 021 021 021 021 021 021 021 021 021 021 021 021 021 021 021 021 021 021 021 021 021 021 021 021 021 021 021 021 021 021 021 001
001 001 001 001 001 001 001 001 001 001 001 001 001 001 001 001 021 001 001 001 001 001 001 001 001 001 001 001 001 001 001 001 001 001 001 001 001 001 001 001 001 001 001 001 001 001 001 001 021 001
